1111111111111111111111111111111111111111
1E00100000000001100000000000000000100001
1000100000C00000M00000000000C00M01100001
1000100000000000000000000000000000000001
1010001011111010001010001011111000110001
1010010010001010001010010000100001001001
1010100010001010001010100000100010000101
1011000010001010C01011000C00100011111101
1010100010001010001010100000100010000101
1P10010010001010001010010000100010C00101
1010001011111011111010001011111010000101
1000100000000000000000000000000000000001
11111000CM00000000C0000000M0000000000001
1000000000000000000000000110000000000001
1111111111111111111111111111111111111111