1111111111111111111111111111111111111111
1E00000000000000000000000000000000000001
100000M000C00000000000000000C00000000001
1000000000000000000000000000000000000001
1010001011111010001010001011111000110001
1010010010001010001010010000100001001001
1010100010001010001010100000100010000101
1011000010001010C01011000C00100011111101
1010100010001010001010100000100010000101
1010010010001010001010010000100010C00101
1010001011111011111010001011111010000101
1000000000000000000000000000000000000001
10000000C000000000C00000000M000000000001
1P00000000000000000000000000000000000001
1111111111111111111111111111111111111111