11111111111111111111111111111111111111111111111111111111111111111111111111111
1E000000000000000000000000000000000000000000000000000000000000000000000000001
10000000000000000000000000000000000000000000000000000000000000000000000000001
10000000000000000000000000000000000000000000000000000000000000000000000000001
10001000100011111100010000100010001000111111100000011000000000000000000000001
10001001000010000100010000100010010000000100000000100100000000011001100000001
10001010000010000100010000100010100000000100000001000010000000100110010000001
1000110000C01000010C01000010C0110000C000010000C011111111000C000100001000C0001
10001010000010000100010000100010100000000100000010000001000000001001000000001
10001001000010000100010000100010010000000100000010000001000000000101000000001
10001000100011111100011111100010001000111111100010000001000000000010000000001
10000000000000000000000000000000000000000000000000000000000000000000000000001
10000000000000000000000000000000000000000000000000000000000000000000000000001
1P000000000000000000000000000000000000000000000000000000000000000000000000001
11111111111111111111111111111111111111111111111111111111111111111111111111111